***********
*         *
***** *****
*         *
***********
